1111111111
1000001001
10E0100C01
1111110011
1P000C0111
1111111111